0 0 250 16 1 300
22 22 22 22 22 22 22 22 22 22 22 22 22 22 22 22 22 22 22 22 22 22 22 22 22 22 22 22 22 22 22 22 22 22 22 22 22 22 22 22 22 22 22 22 22 22 22 22 22 22 22 22 22 22 22 22 22 22 22 22 22 22 22 22 22 22 22 22 22 22 22 22 22 22 22 22 22 22 22 22 22 22 22 22 22 22 22 22 22 22 22 22 22 22 22 22 22 22 22 22 22 22 22 22 22 22 22 22 22 22 22 22 22 22 22 22 22 22 22 22 22 22 22 22 22 22 22 22 22 22 22 22 22 22 22 22 22 22 22 22 22 22 22 22 22 22 22 22 22 22 22 22 22 22 22 22 22 22 22 22 22 22 22 22 22 22 22 22 22 22 22 22 22 22 22 22 22 22 22 22 22 22 22 22 22 22 22 22 22 22 22 22 22 22 22 22 22 22 22 22 22 22 22 22 22 22 22 22 22 22 22 22 22 00 22 22 22 22 22 22 22 22 22 22 22 22 22 22 22 22 22 22 22 22 22 22 22 22 22 22 22 22 22 22 22 22 22 22 22 22 
00 00 00 00 00 00 00 00 00 00 00 00 00 00 00 00 00 00 00 00 00 00 00 00 00 00 00 00 00 00 00 00 00 00 00 00 00 00 00 00 00 00 00 00 00 00 00 00 00 00 00 00 00 00 00 00 00 00 00 00 00 00 00 00 00 00 00 00 00 00 00 00 00 00 00 00 00 00 00 00 00 00 00 00 00 00 00 39 00 38 00 00 00 00 00 00 00 00 00 00 00 00 00 00 00 00 00 00 00 00 00 00 00 00 00 00 00 00 00 00 00 00 00 00 00 00 00 00 00 00 00 00 00 00 00 00 00 00 00 00 00 00 00 00 00 00 00 00 00 00 00 00 00 22 22 22 22 22 22 22 00 00 00 00 00 00 00 00 00 00 00 00 00 00 00 00 00 00 00 00 00 00 00 00 00 00 00 00 00 00 00 00 00 00 00 00 00 00 00 00 00 00 00 00 00 00 00 00 00 00 00 00 00 00 00 00 00 00 00 00 00 00 00 00 00 00 00 00 00 00 00 00 00 00 00 00 00 00 00 00 00 00 00 00 00 00 00 00 00 00 
00 00 00 00 00 00 00 00 00 00 00 00 00 00 00 00 00 00 00 00 00 00 00 00 00 00 00 00 00 00 00 00 00 00 00 00 00 00 00 00 00 00 00 00 00 00 00 00 00 00 00 00 00 00 00 00 00 00 00 00 00 00 00 00 00 00 00 00 00 00 00 00 00 00 22 22 22 22 22 22 22 00 25 26 26 27 02 37 02 37 02 00 00 00 25 26 26 26 27 00 00 00 00 00 00 00 00 00 00 00 00 00 00 00 02 00 00 00 00 00 00 00 00 00 00 00 00 00 00 00 36 33 00 00 00 00 00 00 00 00 00 00 00 00 00 00 15 15 15 00 00 00 00 00 00 00 00 36 00 33 00 00 00 00 00 00 00 00 00 00 00 00 00 00 00 00 00 00 00 00 00 00 00 00 00 00 00 00 00 00 00 00 00 00 22 22 22 22 22 22 22 22 22 00 00 00 00 00 22 22 22 22 22 00 22 22 22 22 00 00 00 00 22 22 22 22 22 22 00 00 00 00 00 00 22 22 22 00 00 00 00 00 00 00 00 00 00 00 00 00 
00 00 00 00 00 00 00 00 00 00 00 00 00 00 00 00 00 00 00 00 00 19 00 00 00 00 00 00 00 00 00 00 00 00 00 00 00 00 00 00 00 00 00 00 00 00 00 00 00 00 00 00 00 00 00 00 00 00 00 00 00 00 00 00 00 00 00 00 00 00 00 00 00 00 00 00 00 00 00 00 00 00 13 13 13 13 13 13 13 13 13 00 00 00 13 13 13 13 19 00 00 00 00 00 00 00 00 00 00 00 00 00 00 00 16 00 00 00 00 00 00 00 00 00 00 00 00 00 00 00 35 32 00 00 00 00 00 00 00 00 00 00 00 00 00 00 00 02 01 00 02 00 00 00 00 00 00 35 00 32 00 00 00 00 00 00 00 00 00 00 00 00 00 00 00 00 00 00 00 00 00 00 00 00 00 00 00 00 00 00 00 00 00 00 00 00 00 00 00 00 00 00 00 00 00 00 00 00 00 00 00 00 00 00 00 00 00 00 00 00 00 00 00 00 00 00 00 00 00 00 00 00 00 00 00 00 00 00 00 22 22 22 22 22 22 00 00 00 00 00 
00 00 22 22 22 22 22 22 22 22 22 22 22 22 00 00 00 00 00 00 00 00 00 00 00 00 00 00 22 22 22 22 22 22 22 22 22 22 00 00 00 00 00 00 00 00 00 00 00 00 00 00 00 00 00 00 00 00 00 00 00 00 00 00 00 00 00 00 00 00 00 00 00 00 00 00 00 00 00 00 00 00 00 00 00 00 00 00 00 00 00 00 00 00 00 00 00 00 00 00 00 00 00 00 00 00 00 00 00 00 00 00 00 00 00 00 00 00 00 00 00 00 00 00 00 15 15 15 15 00 35 32 00 36 33 00 00 00 00 00 00 00 00 00 14 19 14 19 14 16 14 00 00 00 00 00 00 35 00 32 00 00 00 00 00 00 00 00 00 00 00 00 00 00 00 00 00 00 00 00 00 00 00 00 00 00 00 00 00 00 00 00 00 00 00 00 00 00 00 00 00 00 00 00 00 00 00 00 00 00 00 00 00 00 00 00 00 00 00 00 00 00 00 00 00 00 00 00 00 00 00 00 00 00 00 00 00 00 00 00 00 00 00 00 00 00 00 00 00 00 
00 00 00 00 00 00 00 00 00 00 00 00 00 00 00 00 00 00 00 00 00 00 00 00 00 00 00 00 00 00 00 00 00 00 00 00 00 00 00 00 00 00 00 00 00 00 00 00 00 00 00 22 22 22 22 22 22 22 22 22 22 22 22 22 00 00 00 00 00 00 00 00 00 00 00 00 00 00 00 00 00 00 00 00 22 22 22 22 22 22 22 22 22 22 22 00 00 00 00 00 00 22 22 22 22 22 22 22 22 22 22 22 22 00 00 00 00 00 00 00 22 22 22 22 22 22 22 22 22 22 34 31 00 35 32 00 00 00 00 00 00 00 00 00 00 00 00 00 00 00 00 00 00 00 00 00 00 34 00 31 00 00 00 00 00 00 00 00 00 22 22 22 22 22 22 22 22 22 22 22 22 22 00 00 01 13 00 00 00 00 00 00 00 00 00 00 00 00 00 00 00 22 22 22 22 22 22 22 22 00 00 00 00 00 00 00 22 22 22 22 22 22 22 22 00 40 00 00 22 22 22 22 22 22 22 22 00 00 00 00 00 00 00 00 00 00 00 00 00 00 
00 00 00 00 00 00 00 00 00 00 00 00 00 00 00 00 00 00 00 00 00 00 00 00 00 00 00 00 00 00 00 36 00 00 00 00 00 00 00 00 00 00 00 00 00 00 00 00 00 00 00 00 00 00 00 00 00 00 00 33 00 00 00 00 00 00 00 00 00 00 00 00 00 00 00 36 00 00 15 00 15 00 15 00 00 00 00 00 00 00 00 00 00 00 00 00 00 00 00 00 00 00 00 00 00 00 00 00 00 33 00 00 00 00 00 00 00 00 00 00 00 00 00 00 00 00 00 00 00 00 37 37 00 34 31 00 36 33 00 00 00 00 00 00 00 00 00 00 00 00 00 00 00 00 00 00 00 37 00 37 00 00 00 00 00 00 00 00 00 00 15 15 15 15 15 15 15 00 00 00 00 00 00 00 13 13 00 00 00 00 00 00 00 00 00 00 00 00 00 00 00 00 00 00 00 00 00 00 00 00 00 00 00 00 00 00 00 00 00 00 00 00 00 00 00 41 00 00 00 00 00 00 00 00 00 00 00 00 00 00 00 00 00 00 00 00 00 00 00 00 
00 00 00 00 00 00 00 00 00 00 00 00 00 00 00 00 00 00 00 25 26 26 26 27 00 00 00 00 00 00 00 35 00 00 00 00 00 22 22 22 22 22 22 22 22 22 22 22 22 00 00 00 00 00 00 00 00 00 00 32 00 00 15 15 15 00 00 00 00 00 00 00 00 00 00 35 00 00 00 00 00 00 00 00 00 00 00 33 00 00 00 00 00 00 00 00 00 00 00 00 00 00 00 00 00 00 00 00 00 32 00 00 00 00 00 00 00 02 00 00 00 00 00 00 00 00 00 00 00 00 37 37 00 37 37 00 34 31 00 00 00 00 00 00 00 00 00 00 00 00 00 00 00 00 00 00 00 37 00 37 09 11 00 00 00 00 00 00 00 00 00 00 00 00 00 00 00 00 00 00 00 00 02 13 13 13 00 00 16 16 16 16 00 36 33 00 00 00 00 00 00 00 00 00 00 33 00 36 00 00 00 00 00 00 00 00 00 00 00 00 00 00 00 00 00 41 00 00 00 00 00 00 00 00 00 00 22 22 22 22 22 22 22 00 00 00 00 00 00 00 
00 00 00 00 00 00 00 00 00 00 00 33 33 00 00 19 00 00 00 14 18 14 19 14 00 00 00 00 00 00 00 35 00 00 00 00 00 00 00 00 00 00 00 00 00 33 00 00 00 00 00 33 00 00 00 00 00 00 00 32 00 00 00 00 00 00 00 00 00 00 00 00 00 00 00 35 00 00 14 16 14 19 14 00 00 00 00 32 00 00 00 00 00 00 00 00 00 14 16 14 19 14 00 00 00 00 00 00 00 32 00 19 36 00 19 00 00 19 00 00 00 00 00 00 36 00 00 00 00 13 37 37 21 37 37 21 37 37 20 02 23 01 23 02 23 01 23 23 25 26 26 26 26 26 27 23 02 37 23 37 10 12 00 00 00 00 00 00 00 00 14 19 14 16 14 19 14 33 00 00 00 00 13 13 13 13 00 00 00 00 00 00 00 35 32 00 00 00 00 00 00 00 00 00 00 32 00 35 00 00 00 00 00 00 00 00 00 00 00 00 00 00 00 00 00 41 00 00 00 00 00 00 00 00 00 00 00 00 00 00 00 00 00 00 00 00 00 00 00 00 
00 00 00 00 00 00 00 00 00 00 00 32 32 00 00 00 00 00 00 00 00 00 00 00 00 00 00 00 00 00 00 34 00 00 33 00 00 00 00 00 00 00 00 00 00 32 00 00 09 11 00 32 00 00 00 00 00 00 00 31 00 00 00 00 00 00 33 00 36 00 00 00 00 00 00 34 00 00 00 00 00 00 00 00 00 00 00 32 00 00 00 00 00 00 00 00 00 00 00 00 00 36 00 00 00 00 00 00 00 31 00 00 35 00 00 00 00 00 00 00 00 00 00 00 35 00 00 00 00 03 05 05 05 05 05 05 05 05 05 05 05 05 05 05 05 05 05 05 05 05 05 05 05 05 05 05 05 05 05 05 05 07 00 00 00 00 00 00 00 00 00 00 00 00 00 00 00 32 00 00 02 13 13 13 13 13 00 00 00 00 00 00 00 35 32 00 00 00 00 00 00 00 00 00 00 32 00 35 00 00 00 00 00 00 00 00 00 00 00 00 00 00 00 00 00 41 00 00 00 00 00 00 00 00 00 00 00 00 00 00 00 00 00 00 00 00 00 00 00 00 
00 00 00 00 00 00 00 00 00 00 00 31 31 00 00 00 00 00 00 00 00 00 00 00 00 00 33 00 00 00 00 37 09 11 31 00 00 00 00 00 00 00 00 00 33 31 00 00 10 12 00 31 33 00 00 00 00 00 00 37 00 00 00 00 00 00 31 00 34 00 00 00 00 00 00 37 00 00 00 00 00 00 00 00 00 00 00 31 00 00 00 00 00 00 00 00 00 00 00 00 00 34 00 00 00 00 00 09 11 37 00 00 34 00 00 00 00 00 00 00 00 00 00 00 34 00 00 00 00 04 06 06 06 06 06 06 06 06 06 06 06 06 06 06 06 06 06 06 06 06 06 06 06 06 06 06 06 06 06 06 06 08 00 00 00 00 00 00 00 00 00 00 00 00 00 00 00 31 00 00 13 13 13 13 13 13 00 33 36 00 00 00 00 34 31 00 00 00 00 00 00 00 00 00 00 31 00 34 00 00 00 00 00 00 00 00 00 00 00 00 00 00 00 00 00 41 00 00 00 00 00 00 00 00 00 00 00 00 00 00 00 00 00 00 00 00 00 00 00 00 
00 00 00 00 00 00 00 00 00 00 00 37 37 00 00 00 00 00 00 00 00 00 00 00 00 00 32 00 00 00 00 37 10 12 37 00 00 00 00 00 00 00 00 00 31 37 00 00 10 12 00 37 31 00 00 00 00 00 00 37 00 00 00 00 00 00 37 00 37 00 00 00 00 00 00 37 00 00 00 00 00 00 00 00 00 00 00 37 00 00 00 00 00 00 00 00 00 00 00 00 00 37 00 00 00 00 00 10 12 37 00 00 37 00 00 00 00 00 00 00 00 00 00 00 37 00 00 00 00 04 06 06 06 06 06 06 06 06 06 06 06 06 06 06 06 06 06 06 06 06 06 06 06 06 06 06 06 06 06 06 06 08 00 00 00 00 09 11 00 00 00 00 00 00 00 00 00 37 00 13 13 13 13 13 13 13 00 31 34 00 00 00 00 37 37 09 11 00 00 00 00 00 00 00 00 37 42 37 00 00 00 00 00 00 00 00 09 11 00 00 00 00 00 00 00 41 00 00 00 00 00 00 00 00 00 00 00 00 00 00 00 00 00 00 00 00 00 00 00 00 
21 00 23 23 23 23 23 00 20 23 23 37 37 25 26 26 26 26 27 00 00 23 00 23 00 02 31 02 23 02 23 37 10 12 37 23 02 23 01 23 02 23 01 20 37 37 02 00 10 12 21 37 37 20 02 23 01 23 01 37 02 23 25 26 26 27 37 02 37 01 13 00 00 00 13 37 23 01 23 02 23 01 25 26 26 26 27 37 13 00 00 00 13 21 23 01 23 20 02 23 02 37 02 25 26 26 27 10 12 37 00 20 37 23 01 23 02 23 02 25 26 26 26 27 37 13 00 00 00 04 06 06 06 06 06 06 06 06 06 06 06 06 06 06 06 06 06 06 06 06 06 06 06 06 06 06 06 06 06 06 06 08 00 00 00 00 10 12 21 23 02 23 01 23 02 23 01 37 13 13 13 13 13 13 13 13 21 37 37 23 23 21 23 37 37 10 12 25 26 26 26 26 26 27 23 37 23 37 23 25 26 26 26 26 26 27 10 12 21 23 23 23 23 21 23 41 23 23 23 21 23 23 24 00 00 00 00 00 00 00 00 00 00 00 00 00 00 00 00 00 
03 05 05 05 05 05 05 05 05 05 05 05 05 05 05 05 05 05 05 05 05 05 05 05 05 05 05 05 05 05 05 05 05 05 05 05 05 05 05 05 05 05 05 05 05 05 05 05 05 05 05 05 05 05 05 05 05 05 05 05 05 05 05 05 05 05 05 05 05 05 07 00 00 00 03 05 05 05 05 05 05 05 05 05 05 05 05 05 07 00 00 00 03 05 05 05 05 05 05 05 05 05 05 05 05 05 05 05 05 05 05 05 05 05 05 05 05 05 05 05 05 05 05 05 05 07 00 00 00 04 06 06 06 06 06 06 06 06 06 06 06 06 06 06 06 06 06 06 06 06 06 06 06 06 06 06 06 06 06 06 06 08 00 00 00 00 03 05 05 05 05 05 05 05 05 05 05 05 05 05 05 05 05 05 05 05 05 05 05 05 05 05 05 05 05 05 05 05 05 05 05 05 05 05 05 05 05 05 05 05 05 05 05 05 05 05 05 05 05 05 05 05 05 05 05 05 05 05 05 05 05 05 05 05 05 05 05 05 05 05 05 05 05 05 05 05 05 05 05 07 
04 06 06 06 06 06 06 06 06 06 06 06 06 06 06 06 06 06 06 06 06 06 06 06 06 06 06 06 06 06 06 06 06 06 06 06 06 06 06 06 06 06 06 06 06 06 06 06 06 06 06 06 06 06 06 06 06 06 06 06 06 06 06 06 06 06 06 06 06 06 08 00 00 00 04 06 06 06 06 06 06 06 06 06 06 06 06 06 08 00 00 00 04 06 06 06 06 06 06 06 06 06 06 06 06 06 06 06 06 06 06 06 06 06 06 06 06 06 06 06 06 06 06 06 06 08 00 00 00 04 06 06 06 06 06 06 06 06 06 06 06 06 06 06 06 06 06 06 06 06 06 06 06 06 06 06 06 06 06 06 06 08 00 00 00 00 04 06 06 06 06 06 06 06 06 06 06 06 06 06 06 06 06 06 06 06 06 06 06 06 06 06 06 06 06 06 06 06 06 06 06 06 06 06 06 06 06 06 06 06 06 06 06 06 06 06 06 06 06 06 06 06 06 06 06 06 06 06 06 06 06 06 06 06 06 06 06 06 06 06 06 06 06 06 06 06 06 06 06 08 
04 06 06 06 06 06 06 06 06 06 06 06 06 06 06 06 06 06 06 06 06 06 06 06 06 06 06 06 06 06 06 06 06 06 06 06 06 06 06 06 06 06 06 06 06 06 06 06 06 06 06 06 06 06 06 06 06 06 06 06 06 06 06 06 06 06 06 06 06 06 08 00 00 00 04 06 06 06 06 06 06 06 06 06 06 06 06 06 08 00 00 00 04 06 06 06 06 06 06 06 06 06 06 06 06 06 06 06 06 06 06 06 06 06 06 06 06 06 06 06 06 06 06 06 06 08 00 00 00 04 06 06 06 06 06 06 06 06 06 06 06 06 06 06 06 06 06 06 06 06 06 06 06 06 06 06 06 06 06 06 06 08 00 00 00 00 04 06 06 06 06 06 06 06 06 06 06 06 06 06 06 06 06 06 06 06 06 06 06 06 06 06 06 06 06 06 06 06 06 06 06 06 06 06 06 06 06 06 06 06 06 06 06 06 06 06 06 06 06 06 06 06 06 06 06 06 06 06 06 06 06 06 06 06 06 06 06 06 06 06 06 06 06 06 06 06 06 06 06 08 
