0 0 250 15 5 300
22 22 22 22 22 22 22 00 22 22 22 22 22 22 00 00 00 00 22 22 22 22 22 22 22 22 00 00 22 22 22 22 22 22 22 22 22 22 00 22 22 22 22 22 22 00 00 00 00 00 22 22 22 22 22 22 22 22 22 00 00 00 22 22 22 22 22 22 22 00 00 22 22 22 22 22 00 00 00 00 22 22 22 22 22 22 22 15 15 15 15 00 00 39 22 22 22 22 22 19 16 19 22 22 22 22 22 22 22 22 14 19 19 19 14 22 22 33 22 22 00 00 38 22 14 19 17 19 19 14 22 22 22 22 00 36 00 22 22 22 00 22 15 15 15 15 22 00 22 22 22 00 00 00 22 22 22 15 15 22 22 00 22 22 22 00 00 00 22 22 22 22 22 22 00 22 22 22 22 00 00 00 00 22 22 22 00 22 22 22 00 22 00 22 00 15 15 22 22 22 22 22 00 22 22 22 22 00 00 22 22 00 22 22 22 22 22 00 00 00 22 22 22 09 11 00 00 22 22 22 22 22 22 22 00 00 22 22 22 22 00 00 22 00 22 22 00 22 22 22 
00 00 00 22 22 22 22 22 00 00 00 00 00 00 22 22 22 22 22 22 22 00 00 00 00 00 00 00 00 00 00 22 22 22 22 22 22 22 00 00 22 22 22 22 00 00 00 22 22 22 22 22 22 22 22 00 00 00 00 00 00 22 22 22 00 00 00 00 00 00 00 00 22 22 22 22 22 00 00 00 00 00 00 00 00 22 22 22 22 22 22 22 00 37 38 22 22 22 22 00 00 00 00 22 22 22 22 22 39 00 00 00 00 00 22 22 22 32 22 15 15 15 37 00 22 22 22 22 15 15 15 15 22 00 00 35 22 22 22 00 22 22 00 22 22 22 22 00 22 22 22 22 00 00 22 22 22 22 22 00 00 19 16 19 19 22 22 22 00 00 22 22 22 00 00 22 22 00 22 22 22 00 19 19 19 19 00 22 22 22 22 00 00 22 22 00 00 00 22 00 22 00 22 00 22 22 22 22 00 00 22 22 00 00 00 22 00 00 22 22 00 22 22 10 12 00 22 22 22 22 22 00 22 22 22 00 22 22 22 00 00 22 00 22 00 00 22 00 00 00 
00 00 00 00 00 00 00 00 00 00 00 00 00 00 00 00 00 00 00 00 00 00 00 00 00 00 00 00 00 00 00 00 00 00 00 00 00 00 00 15 00 00 00 00 00 00 00 00 00 00 00 00 00 00 00 00 00 00 00 00 00 00 00 00 00 00 00 00 00 00 00 00 00 00 00 00 00 00 00 00 00 00 00 39 00 23 23 23 01 23 23 01 23 37 37 02 00 00 00 00 00 00 00 00 00 00 00 00 37 00 00 00 00 38 00 00 00 31 00 00 00 00 37 00 00 00 00 00 00 00 00 00 00 00 00 34 00 00 00 00 00 00 00 00 00 00 00 00 00 00 00 00 00 00 00 00 00 00 00 00 39 00 00 00 00 00 00 00 00 15 15 15 15 00 00 00 00 00 00 00 00 00 00 00 00 00 00 00 00 39 00 00 00 00 00 16 19 00 00 00 00 00 00 00 00 00 00 00 00 00 00 00 00 00 00 00 00 00 00 00 00 00 00 10 12 00 00 00 00 00 39 00 00 00 00 00 00 00 00 00 00 00 22 00 00 22 00 00 22 22 
00 00 00 00 00 00 00 00 00 00 00 00 00 00 00 00 00 00 00 00 00 00 00 00 00 00 00 00 00 00 00 00 00 00 00 00 00 00 13 13 13 00 00 00 00 00 00 00 00 00 00 00 00 00 00 00 00 00 00 00 00 00 00 00 00 00 00 00 00 00 00 00 00 00 00 00 00 00 00 00 00 00 00 37 00 03 05 05 05 05 05 05 05 05 05 05 07 00 00 00 00 00 00 00 00 00 00 00 37 00 00 00 00 37 00 00 00 37 00 00 00 00 37 00 00 00 00 00 00 00 00 00 00 00 00 37 00 00 00 00 00 00 00 00 00 00 00 00 00 00 00 00 00 00 00 00 00 00 00 00 37 00 00 00 00 38 00 00 00 00 00 00 00 00 00 00 00 00 00 00 00 00 00 00 00 00 00 00 00 37 00 00 00 00 00 00 00 00 00 00 00 00 00 00 00 00 00 00 00 00 00 15 15 00 00 00 00 00 00 00 00 00 39 10 12 00 00 00 00 00 37 00 00 00 00 00 00 00 00 00 00 00 00 00 00 00 00 00 00 00 
00 00 00 00 00 00 00 00 00 00 00 00 00 00 00 00 00 00 00 00 00 00 00 00 00 00 00 00 00 00 00 00 00 00 15 00 00 00 00 00 00 00 00 00 15 00 00 00 00 00 00 00 00 00 00 00 00 00 00 00 00 00 00 15 15 15 15 15 00 00 00 00 00 00 00 00 00 00 00 00 00 00 00 37 00 04 06 06 06 06 06 06 06 06 06 06 08 23 23 23 02 23 02 00 13 00 00 13 37 23 23 23 01 37 00 02 01 37 21 20 00 02 37 01 02 00 23 23 23 02 23 23 02 00 01 37 13 00 00 13 23 23 23 02 00 02 00 00 00 15 15 15 15 15 15 00 00 00 00 00 37 00 00 00 00 37 00 00 00 00 00 00 00 00 00 00 00 00 00 00 00 00 00 00 00 00 00 00 00 37 00 00 00 00 00 00 00 00 00 00 00 00 00 38 00 00 00 00 00 00 14 14 14 14 00 00 00 00 00 00 00 00 37 10 12 00 00 00 00 00 37 00 40 00 00 00 00 00 00 00 00 00 00 00 00 00 00 00 00 00 
00 00 00 00 00 00 00 00 00 00 00 00 00 15 15 00 00 15 15 00 00 15 15 00 00 00 00 00 00 00 00 00 00 13 13 13 00 00 00 00 00 00 00 13 13 13 00 00 00 00 00 00 00 00 00 00 00 00 00 00 00 00 00 14 14 14 14 14 00 00 00 00 00 00 00 00 00 00 00 00 13 23 02 37 02 04 06 06 06 06 06 06 06 06 06 06 06 05 05 05 05 05 05 05 07 00 00 03 05 05 05 05 05 05 05 05 05 05 05 05 05 05 05 05 05 05 05 05 05 05 05 05 05 05 05 05 07 00 00 03 05 05 05 05 05 05 07 00 00 00 00 00 00 00 00 00 21 20 23 02 37 02 00 02 00 37 01 23 23 00 02 00 01 00 13 00 00 13 02 23 23 23 02 28 29 29 29 29 30 37 01 13 00 00 00 00 00 00 00 00 13 23 23 37 02 13 00 00 00 00 00 00 00 00 00 00 00 00 13 00 01 23 37 10 12 00 00 00 00 38 37 00 41 00 00 00 00 00 00 00 00 00 00 00 00 00 00 00 00 00 
00 00 00 00 00 00 00 00 00 00 00 00 00 00 00 00 00 00 36 00 00 00 00 00 00 00 00 00 00 15 00 00 00 00 00 00 00 00 00 00 00 00 00 00 00 00 00 00 00 15 00 00 00 00 00 00 00 00 00 00 00 00 00 00 00 00 00 00 00 00 33 00 00 00 00 00 00 00 00 00 03 05 05 05 05 06 06 06 06 06 06 06 06 06 06 06 06 06 06 06 06 06 06 06 08 00 00 04 06 06 06 06 06 06 06 06 06 06 06 06 06 06 06 06 06 06 06 06 06 06 06 06 06 06 06 06 08 00 00 04 06 06 06 06 06 06 06 07 00 00 00 00 00 00 00 00 03 05 05 05 05 05 05 05 05 05 05 05 05 05 05 05 05 05 07 00 00 03 05 05 05 05 05 05 05 05 05 05 05 05 05 07 00 00 00 00 00 00 00 00 03 05 05 05 05 07 00 00 00 00 00 00 00 00 00 00 00 00 03 05 05 05 05 05 07 00 00 00 00 37 37 00 41 00 00 00 00 00 00 00 00 00 00 00 00 00 00 00 00 00 
00 00 00 00 00 00 00 00 00 00 00 00 00 00 00 00 00 00 35 00 00 00 33 00 00 00 00 00 13 13 13 00 00 00 00 00 00 00 00 00 00 00 00 00 00 00 00 00 13 13 13 00 00 00 00 00 00 02 02 00 00 00 00 00 00 00 00 00 00 00 32 00 00 00 00 00 00 00 00 00 04 08 00 00 00 15 15 15 15 00 00 00 00 00 00 00 00 00 00 00 00 00 00 00 37 00 00 37 00 15 15 15 15 00 00 00 00 00 00 00 00 00 00 00 00 00 00 00 00 38 00 00 00 00 00 00 37 00 00 37 00 00 00 00 00 00 00 37 07 00 00 00 00 00 00 03 37 00 00 00 00 00 00 00 15 15 15 15 15 00 00 00 00 00 37 00 00 37 00 00 00 00 00 00 00 00 00 00 00 00 00 37 00 00 00 15 15 00 00 00 37 00 00 00 00 37 00 00 00 00 00 00 00 00 00 00 00 00 37 00 00 00 00 00 37 00 00 00 00 37 37 00 41 00 00 00 00 00 00 00 00 00 00 00 00 00 00 00 00 00 
00 00 00 00 00 00 00 00 00 00 00 19 19 00 00 19 19 00 34 19 19 00 32 19 19 00 00 00 00 00 00 00 00 00 00 00 00 00 00 00 00 00 00 00 00 00 00 00 00 00 00 00 00 00 00 00 19 19 18 19 00 00 00 00 00 00 00 00 00 00 32 00 00 00 00 15 15 15 00 00 04 08 00 00 00 14 14 14 14 00 00 00 00 00 00 00 00 00 00 00 00 00 00 00 37 00 00 37 00 14 14 14 14 00 00 00 00 15 15 15 15 15 15 15 15 15 15 15 00 37 00 00 00 00 00 00 37 00 00 37 00 00 15 15 15 00 00 37 15 07 23 01 23 01 03 15 37 00 00 00 00 00 00 00 14 14 14 14 14 00 00 38 00 00 37 00 00 37 00 00 00 00 15 15 15 15 15 15 15 00 00 37 00 00 00 13 13 00 00 00 37 00 00 00 00 37 38 00 00 00 00 00 00 00 00 00 00 00 37 00 00 00 00 00 37 00 00 00 00 03 07 00 41 00 00 00 00 00 00 00 00 00 00 00 00 00 00 00 00 00 
00 00 00 00 00 00 00 00 00 00 38 00 00 00 39 00 00 00 37 00 00 00 31 00 00 00 00 00 00 00 00 00 00 00 00 00 00 00 00 00 00 00 00 00 00 00 00 00 00 00 00 00 00 00 00 00 00 00 00 00 00 00 00 00 00 00 00 00 00 00 31 00 00 00 00 13 13 13 00 00 04 08 00 00 00 00 00 00 00 00 00 00 00 00 00 00 15 15 15 15 15 00 00 00 37 00 00 37 00 00 00 00 00 00 00 00 00 00 00 00 00 00 00 00 00 00 00 00 00 37 00 00 00 00 00 00 37 00 00 37 00 00 00 00 00 00 00 37 00 15 05 05 05 05 15 00 37 00 00 00 00 00 39 00 00 00 00 00 00 00 00 37 00 00 37 00 00 37 00 00 00 00 00 00 38 00 00 00 00 00 00 37 00 00 00 00 00 00 00 00 37 00 00 00 00 37 37 00 00 00 00 00 00 00 00 00 00 00 37 00 00 00 00 00 37 00 00 23 03 06 08 00 41 00 00 00 00 00 00 00 00 00 00 00 00 00 00 00 00 00 
00 00 00 00 00 00 13 13 00 00 37 00 00 00 37 00 00 00 37 00 00 00 37 00 00 00 00 00 00 00 00 00 00 00 00 00 00 00 00 00 00 00 00 00 00 00 00 00 00 00 00 00 00 00 00 00 39 00 00 00 00 00 00 00 00 00 00 00 00 00 37 00 00 00 00 00 00 00 00 00 04 08 00 00 00 00 00 00 00 00 00 00 00 00 00 00 00 00 00 00 00 00 00 00 37 00 00 37 00 00 00 00 00 00 00 39 00 00 00 00 00 00 00 00 00 00 00 00 00 37 00 00 00 00 00 00 37 00 00 37 00 00 00 00 00 00 00 37 00 00 15 15 15 15 00 00 37 00 00 00 00 00 37 00 00 00 00 00 00 00 00 37 00 00 37 00 00 37 00 00 00 39 00 00 37 00 00 00 00 00 00 37 00 00 00 00 00 00 00 00 37 00 00 00 00 37 37 00 00 00 00 00 00 00 00 00 00 00 37 00 00 00 39 00 37 00 00 03 06 06 08 00 41 00 00 00 00 00 00 00 00 00 00 00 00 00 00 00 00 00 
00 00 00 00 00 00 13 13 00 00 37 00 00 00 37 00 00 00 37 00 00 00 37 00 00 00 00 00 00 00 00 00 00 00 00 00 00 00 00 00 00 00 00 00 00 00 00 00 00 00 00 00 00 00 00 00 37 00 00 00 00 00 00 00 00 00 00 00 00 00 37 00 00 00 00 00 00 00 00 00 04 08 00 00 00 00 00 00 00 00 00 00 00 00 00 00 00 00 00 00 00 00 00 00 37 00 00 37 00 00 00 00 00 00 00 37 00 00 00 00 00 00 00 00 00 00 00 00 00 37 00 00 00 00 00 00 37 00 00 37 00 00 00 00 00 00 00 37 00 00 15 15 15 15 00 00 37 00 00 00 00 00 37 00 00 00 00 00 00 00 00 37 00 00 37 00 00 37 00 00 00 37 00 00 37 00 00 00 00 00 00 37 00 00 00 00 00 00 00 00 37 00 00 00 00 37 37 00 00 00 00 00 00 00 00 00 00 00 37 00 00 00 37 00 37 23 03 06 06 06 08 00 41 00 00 00 00 00 00 00 00 00 00 00 00 00 00 00 00 00 
00 23 23 23 20 21 13 13 01 01 37 01 01 01 37 01 01 01 37 01 01 01 37 01 01 01 13 00 00 00 00 00 00 00 00 00 00 00 00 00 00 00 00 00 00 00 00 00 00 00 00 00 13 00 01 01 37 21 23 23 01 01 20 00 00 25 26 26 26 27 37 01 13 00 00 00 00 00 00 00 04 08 23 23 02 00 00 01 23 23 23 02 00 00 02 00 00 01 00 23 23 00 02 00 13 00 00 13 01 00 02 23 23 01 00 37 00 02 25 26 26 26 26 27 01 00 00 02 00 37 02 00 23 23 23 01 13 00 00 13 00 02 23 23 23 02 00 13 00 00 15 15 15 15 00 00 13 23 23 23 00 02 37 01 00 02 00 01 00 02 23 37 23 02 13 00 00 13 23 23 01 37 02 00 37 02 23 23 02 01 00 37 23 13 00 00 00 00 13 23 37 21 20 01 23 37 37 02 23 23 02 00 00 02 00 00 42 00 37 23 23 01 37 00 37 03 06 06 06 06 08 00 41 00 21 00 00 00 00 24 00 00 00 00 00 00 00 00 00 00 
03 05 05 05 05 05 05 05 05 05 05 05 05 05 05 05 05 05 05 05 05 05 05 05 05 05 07 00 00 00 00 00 00 00 00 00 00 00 00 00 00 00 00 00 00 00 00 00 00 00 00 00 03 05 05 05 05 05 05 05 05 05 05 05 05 05 05 05 05 05 05 05 07 00 00 00 00 00 00 00 04 06 05 05 05 05 05 05 05 05 05 05 05 05 05 05 05 05 05 05 05 05 05 05 05 05 05 05 05 05 05 05 05 05 05 05 05 05 05 05 05 05 05 05 05 05 05 05 05 05 05 05 05 05 05 05 05 05 05 05 05 05 05 05 05 05 05 05 05 05 05 05 05 05 05 05 05 05 05 05 05 05 05 05 05 05 05 05 05 05 05 05 05 05 05 05 05 05 05 05 05 05 05 05 05 05 05 05 05 05 05 05 05 07 00 00 00 00 03 05 05 05 05 05 05 05 05 05 05 05 05 05 05 05 05 05 05 05 05 05 05 05 05 05 05 06 06 06 06 06 06 05 05 05 05 05 05 05 05 05 05 05 05 05 05 05 05 05 05 07 
04 06 06 06 06 06 06 06 06 06 06 06 06 06 06 06 06 06 06 06 06 06 06 06 06 06 08 00 00 00 00 00 00 00 00 00 00 00 00 00 00 00 00 00 00 00 00 00 00 00 00 00 04 06 06 06 06 06 06 06 06 06 06 06 06 06 06 06 06 06 06 06 08 00 00 00 00 00 00 00 04 06 06 06 06 06 06 06 06 06 06 06 06 06 06 06 06 06 06 06 06 06 06 06 06 06 06 06 06 06 06 06 06 06 06 06 06 06 06 06 06 06 06 06 06 06 06 06 06 06 06 06 06 06 06 06 06 06 06 06 06 06 06 06 06 06 06 06 06 06 06 06 06 06 06 06 06 06 06 06 06 06 06 06 06 06 06 06 06 06 06 06 06 06 06 06 06 06 06 06 06 06 06 06 06 06 06 06 06 06 06 06 06 08 00 00 00 00 04 06 06 06 06 06 06 06 06 06 06 06 06 06 06 06 06 06 06 06 06 06 06 06 06 06 06 06 06 06 06 06 06 06 06 06 06 06 06 06 06 06 06 06 06 06 06 06 06 06 06 08 
