0 0 250 15 4 300
22 22 22 22 22 22 22 00 22 22 22 22 22 22 00 00 00 00 22 22 22 22 22 22 22 22 00 00 22 22 22 22 22 22 22 22 22 22 00 22 22 22 22 22 22 00 00 00 00 00 22 22 22 22 22 22 22 22 22 00 00 00 22 22 22 22 22 22 22 00 00 22 22 22 22 22 00 00 00 00 22 22 22 22 22 22 22 00 00 00 00 00 00 00 22 22 22 22 22 22 00 00 22 22 22 22 22 22 22 22 22 00 22 22 22 22 22 22 22 22 00 00 22 22 22 00 22 22 22 00 22 22 22 22 00 00 00 22 22 22 00 22 22 00 22 22 22 00 22 22 22 00 00 00 22 22 22 00 00 22 22 00 22 22 22 00 00 00 15 15 15 15 22 22 00 22 22 22 22 00 00 00 00 22 22 22 00 22 22 22 00 22 38 22 00 00 00 22 22 22 22 22 00 22 22 22 22 00 00 22 22 00 22 22 22 22 22 00 00 00 22 22 22 00 00 00 00 22 22 22 22 22 22 22 00 00 22 22 22 22 00 00 22 00 22 22 00 22 22 22 
00 00 00 22 22 22 22 22 00 00 00 00 00 00 22 22 22 22 22 22 22 00 00 00 00 00 00 00 00 00 00 22 22 22 22 22 22 22 00 00 22 22 22 22 00 00 00 22 22 22 22 22 22 22 22 00 00 00 00 00 00 22 22 22 00 15 15 15 15 15 00 00 22 22 22 22 22 00 00 00 00 00 00 00 00 22 22 22 22 22 22 22 00 00 00 22 22 22 22 00 00 00 00 22 22 22 22 22 00 00 00 00 00 00 22 22 22 22 22 00 00 00 00 00 00 00 22 22 15 15 15 15 22 15 15 15 22 22 22 00 22 22 00 22 22 22 22 00 22 22 22 22 00 00 22 22 22 22 22 00 00 00 22 22 22 22 22 22 00 00 22 22 22 00 00 22 22 00 22 22 22 00 22 22 22 22 00 22 22 22 22 00 37 22 22 00 00 00 22 00 22 00 22 00 22 22 22 22 00 00 22 22 15 15 15 22 00 00 22 22 00 22 22 00 00 00 22 22 22 22 22 00 22 22 22 00 22 22 22 00 00 22 00 22 00 00 22 00 00 00 
00 00 00 00 00 00 00 00 00 00 00 00 00 00 00 00 00 00 00 00 00 00 00 00 00 00 00 00 00 00 00 00 00 00 00 00 00 00 00 00 00 15 15 15 15 00 00 00 00 00 00 00 00 00 00 00 00 00 00 00 00 00 00 00 00 13 13 13 13 13 00 00 00 00 00 00 15 15 15 00 00 00 00 00 00 00 00 00 00 00 00 00 00 00 00 00 00 00 00 00 00 00 00 00 00 00 00 00 00 00 00 00 00 00 00 00 00 00 00 00 00 00 00 00 00 00 00 00 00 00 00 00 00 00 00 00 00 00 00 00 00 00 00 36 00 02 00 02 00 00 00 00 00 00 00 00 00 00 00 00 00 00 00 00 00 00 00 02 25 26 26 26 27 02 00 00 00 00 00 00 00 00 00 00 15 15 15 15 15 15 39 00 37 00 00 00 00 00 00 00 00 00 00 00 00 00 00 39 00 00 00 00 02 00 02 00 00 00 00 00 00 00 00 00 00 00 00 00 00 00 00 00 00 00 00 00 00 00 00 00 00 00 22 00 00 22 00 00 22 22 
00 00 00 00 00 00 00 00 00 00 00 00 00 00 00 00 00 18 00 00 00 00 00 00 00 00 00 00 00 00 00 15 15 02 15 15 02 00 00 00 00 14 14 14 14 00 00 00 00 00 00 00 00 00 00 00 00 00 00 00 00 00 00 00 00 00 00 00 00 00 00 00 00 00 00 00 00 00 00 00 00 00 00 00 00 00 00 00 00 00 00 00 00 00 00 00 00 15 15 00 00 00 00 00 00 00 00 00 00 00 00 00 16 00 00 00 00 00 00 00 00 00 00 00 00 00 00 00 00 00 00 00 00 00 00 00 00 00 00 00 00 00 00 35 13 19 19 19 13 00 00 00 00 00 00 00 00 00 00 00 00 00 00 00 00 00 00 14 14 13 13 13 14 14 00 00 00 00 00 00 00 00 00 00 00 00 00 00 00 00 37 00 37 00 00 00 00 00 00 00 00 00 00 00 00 00 00 37 00 00 00 14 14 14 14 14 00 00 00 00 00 00 00 00 00 00 00 00 00 00 00 00 00 00 00 00 00 00 00 00 00 00 00 00 00 00 00 00 00 00 
00 00 00 00 00 00 00 00 00 00 00 00 00 00 00 00 00 00 00 00 00 00 00 00 00 00 00 00 00 00 00 14 14 14 14 14 14 14 00 00 00 00 00 00 00 00 00 00 00 00 00 00 00 00 00 00 00 00 00 00 00 00 00 00 00 00 00 00 00 00 00 00 00 00 00 00 00 02 02 00 00 00 00 00 00 00 00 00 00 00 00 00 00 00 00 00 00 13 13 00 00 00 00 00 00 00 00 00 00 00 00 00 00 00 00 00 00 00 00 00 00 00 00 00 00 00 00 00 23 02 23 23 02 00 01 00 00 00 00 00 00 00 00 34 00 00 00 00 00 00 00 00 00 00 00 00 00 00 00 00 00 00 00 00 00 00 00 00 00 00 00 00 00 00 00 00 00 00 00 00 00 23 23 23 02 01 01 02 00 02 37 02 37 25 26 26 26 27 23 23 00 00 00 00 00 00 00 37 00 00 00 00 00 00 00 00 00 00 38 00 00 00 00 00 00 00 00 00 00 00 00 00 40 00 00 00 00 00 00 00 00 00 00 00 00 00 00 00 00 00 
00 00 00 00 00 00 00 00 00 00 00 00 00 00 00 00 00 00 00 00 00 00 00 00 00 00 00 00 00 00 00 00 00 00 00 00 00 00 00 00 00 00 00 00 00 00 00 00 00 00 00 00 00 00 00 00 15 15 02 15 15 00 00 00 00 00 00 00 00 00 00 00 00 00 00 13 13 13 13 13 00 00 00 00 00 00 00 00 00 00 00 00 00 00 15 15 00 00 00 00 00 00 00 00 00 00 00 00 00 00 00 00 00 00 00 00 00 00 00 00 00 00 00 00 00 00 00 03 05 05 05 05 05 05 05 05 07 00 00 00 00 00 00 37 00 00 00 00 00 00 00 00 00 00 00 00 00 00 00 00 00 00 00 00 00 00 00 00 00 00 00 00 00 00 00 00 00 00 00 00 03 05 05 05 05 05 05 05 05 05 05 05 05 05 05 05 05 05 05 07 00 00 00 00 00 00 00 37 00 00 00 00 00 00 00 00 00 00 37 00 00 00 00 00 00 00 00 15 15 00 00 00 41 00 00 00 00 00 00 00 00 00 00 00 00 00 00 00 00 00 
00 00 00 00 00 00 00 00 00 00 00 36 00 00 00 00 00 00 00 00 00 00 00 00 00 00 00 00 00 00 00 00 00 00 00 00 00 39 00 00 00 00 00 00 00 00 00 00 00 00 00 00 00 00 00 00 13 13 13 13 13 00 00 00 00 00 00 00 00 00 33 00 00 00 00 00 00 00 00 00 00 00 00 00 00 00 00 00 00 00 00 00 00 00 13 13 00 00 00 00 00 00 00 15 15 15 00 00 00 00 00 00 00 00 00 00 00 00 00 00 00 00 00 00 00 00 00 04 06 06 06 06 06 06 06 06 08 00 00 00 00 00 00 37 00 00 00 00 00 00 00 00 00 00 00 00 00 00 00 00 00 00 00 00 00 00 00 00 00 00 00 00 00 00 00 00 00 00 00 00 00 37 15 15 15 15 15 15 37 00 04 06 06 06 06 06 06 06 06 08 00 39 00 00 00 00 00 37 00 00 00 00 00 00 00 00 00 00 37 00 00 00 00 00 00 00 00 13 13 00 00 00 41 00 00 00 00 00 00 00 00 00 00 00 00 00 00 00 00 00 
00 00 00 00 00 00 00 00 00 00 00 35 00 13 00 02 02 00 00 02 02 00 00 33 00 00 00 00 00 00 00 00 00 00 00 00 00 37 00 00 00 00 00 00 00 00 00 33 00 00 00 00 00 00 00 00 00 00 00 00 00 00 00 00 00 00 00 00 00 00 32 00 00 00 00 00 00 00 02 02 00 00 00 00 00 00 00 00 00 00 00 15 15 00 00 00 00 00 00 00 00 00 15 02 02 02 15 00 00 00 00 00 00 00 00 00 00 00 00 00 00 00 15 15 00 00 00 04 06 06 06 06 06 06 06 06 08 00 00 00 00 13 00 37 23 23 23 02 01 02 13 00 00 00 00 00 00 00 00 13 00 02 00 00 13 00 00 00 00 33 00 00 00 00 00 00 00 00 00 00 00 37 00 00 00 38 00 00 37 00 00 00 13 00 00 00 00 00 00 13 00 37 38 00 00 00 00 37 00 00 02 00 00 00 00 02 00 00 37 00 00 00 00 00 15 15 00 00 00 00 00 00 41 00 00 00 00 00 00 00 00 00 00 00 00 00 00 00 00 00 
00 00 00 00 00 00 00 00 00 00 00 35 00 14 19 19 19 14 19 19 19 14 00 32 00 00 00 00 00 00 00 00 00 00 00 00 00 37 00 00 00 19 17 19 19 00 36 32 00 00 00 00 00 00 00 00 00 00 00 00 00 00 00 00 00 00 00 00 00 00 32 00 00 00 14 19 16 19 19 19 14 00 00 00 36 00 00 00 00 00 00 13 13 00 00 00 00 00 00 00 00 00 14 14 14 14 14 00 00 19 00 00 19 00 00 19 00 39 00 00 00 00 13 13 00 00 00 04 06 06 06 06 06 06 06 06 08 00 00 00 00 03 05 05 05 05 05 05 05 05 07 00 00 00 00 00 00 00 00 13 19 19 16 19 13 00 00 00 00 32 00 00 00 00 00 00 15 15 00 00 00 37 00 39 00 37 00 00 37 00 00 00 37 00 36 00 00 00 00 37 00 37 37 00 00 00 00 37 19 16 19 19 00 00 19 19 19 19 37 00 00 00 00 00 13 13 00 00 00 00 00 00 41 00 00 00 00 00 00 00 00 00 00 00 00 00 00 00 00 00 
00 00 00 00 00 00 00 00 00 00 00 34 00 00 00 00 00 00 00 00 00 00 00 31 00 13 13 00 00 00 00 00 00 00 00 00 00 37 00 00 00 00 00 00 00 00 35 32 00 00 00 00 00 00 00 00 00 00 00 00 00 00 00 00 00 00 00 00 00 00 31 00 00 00 00 00 00 00 00 00 00 00 00 00 35 00 00 00 15 15 00 00 00 00 00 00 00 00 00 00 00 00 00 00 00 00 00 00 38 00 00 00 00 00 00 00 00 37 00 00 00 00 00 00 00 00 00 04 06 06 06 06 06 06 06 06 08 00 00 00 00 04 06 06 06 06 06 06 06 06 08 00 00 00 00 00 00 00 00 00 00 00 00 00 00 00 00 00 00 31 00 00 00 00 00 00 13 13 00 00 00 37 00 37 00 37 00 00 37 00 00 00 37 00 35 00 00 00 00 37 00 37 37 00 00 00 00 37 00 00 00 00 00 00 00 00 00 00 37 00 00 15 15 00 00 00 00 00 00 00 00 00 41 00 00 00 00 00 00 00 00 00 00 00 00 00 00 00 00 00 
00 00 00 00 00 00 00 00 39 00 00 37 00 00 00 00 00 00 00 00 00 00 00 37 00 13 13 00 00 00 00 00 00 00 00 00 00 37 00 00 00 00 00 00 00 00 34 31 00 00 00 00 00 00 00 00 00 00 00 00 00 00 00 00 00 00 00 00 00 00 37 00 00 00 00 00 00 00 00 00 00 00 00 00 34 00 00 00 13 13 00 00 00 00 00 00 00 00 00 00 00 00 00 00 00 00 00 00 37 00 00 39 00 00 00 00 00 37 00 00 00 00 00 00 00 00 00 04 06 06 06 06 06 06 06 06 08 00 00 00 00 04 06 06 06 06 06 06 06 06 08 00 00 00 00 00 00 00 00 00 00 00 00 00 00 00 00 00 00 37 00 39 00 00 00 00 00 00 00 00 23 37 02 37 02 37 02 01 37 23 00 00 37 00 34 00 00 00 00 37 00 13 13 00 00 00 00 37 00 00 00 00 00 00 00 00 00 00 37 09 11 13 13 00 00 00 00 00 00 00 00 00 41 00 00 00 00 00 00 00 00 00 00 00 00 00 00 00 00 00 
00 00 00 00 00 00 00 00 37 00 00 37 00 00 00 00 00 00 00 00 00 00 00 37 00 13 13 00 00 00 00 00 00 00 38 00 00 37 00 00 00 00 00 00 00 00 37 37 00 00 00 00 09 11 00 00 00 00 00 00 00 00 00 00 00 00 00 00 00 00 37 00 00 00 00 00 00 00 00 00 00 00 00 00 37 00 00 00 00 00 00 00 00 00 00 00 00 00 00 00 00 00 00 00 00 00 00 00 37 00 00 37 00 00 00 00 00 37 00 00 00 00 00 00 00 00 00 04 06 06 06 06 06 06 06 06 08 00 00 00 00 04 06 06 06 06 06 06 06 06 08 00 00 00 00 00 00 00 00 00 00 00 00 00 00 00 00 00 00 37 00 37 00 00 00 00 00 00 00 00 03 05 05 05 05 05 05 05 05 07 00 00 37 00 37 00 00 00 00 37 00 13 13 00 00 00 00 37 00 00 00 00 00 00 00 00 00 00 37 10 12 00 00 00 00 00 00 00 00 00 00 00 41 00 00 00 00 00 00 00 00 00 00 00 00 00 00 00 00 00 
00 23 23 23 21 20 00 00 37 00 01 37 01 23 23 01 23 23 23 25 26 26 27 37 00 13 13 00 00 00 13 23 23 23 37 02 02 37 01 20 20 02 02 00 01 01 37 37 25 26 26 27 10 12 00 00 00 00 00 00 00 00 00 13 02 25 26 26 26 27 37 20 20 00 01 01 00 01 01 23 23 23 02 02 37 13 00 00 00 00 00 00 00 00 00 00 00 00 00 13 23 23 23 01 01 20 00 20 37 01 01 37 00 00 00 02 02 37 00 13 00 00 00 00 00 00 00 04 06 06 06 06 06 06 06 06 08 00 00 00 00 04 06 06 06 06 06 06 06 06 08 00 00 00 00 00 13 23 23 23 00 00 02 23 02 23 01 23 02 37 23 37 01 23 01 01 20 20 21 00 04 06 06 06 06 06 06 06 06 08 23 23 37 02 37 02 23 23 02 37 01 13 13 01 23 23 23 37 00 20 20 00 00 42 23 23 23 01 37 10 12 00 00 00 00 00 00 00 00 00 00 00 41 00 00 00 00 00 00 24 00 00 00 00 00 00 00 00 00 00 
03 05 05 05 05 05 05 05 05 05 05 05 05 05 05 05 05 05 05 05 05 05 05 05 05 05 07 00 00 00 03 05 05 05 05 05 05 05 05 05 05 05 05 05 05 05 05 05 05 05 05 05 05 07 00 00 00 00 00 00 00 00 00 03 05 05 05 05 05 05 05 05 05 05 05 05 05 05 05 05 05 05 05 05 05 07 00 00 00 00 00 00 00 00 00 00 00 00 00 03 05 05 05 05 05 05 05 05 05 05 05 05 05 05 05 05 05 05 05 07 00 00 00 00 00 00 00 04 06 06 06 06 06 06 06 06 08 00 00 00 00 04 06 06 06 06 06 06 06 06 08 00 00 00 00 00 03 05 05 05 05 05 05 05 05 05 05 05 05 05 05 05 05 05 05 05 05 05 05 05 06 06 06 06 06 06 06 06 06 06 05 05 05 05 05 05 05 05 05 05 05 05 05 05 05 05 05 05 05 05 05 05 05 05 05 05 05 05 05 05 07 00 00 00 00 00 00 00 00 00 00 03 05 05 05 05 05 05 05 05 05 05 05 05 05 05 05 05 05 07 
04 06 06 06 06 06 06 06 06 06 06 06 06 06 06 06 06 06 06 06 06 06 06 06 06 06 08 00 00 00 04 06 06 06 06 06 06 06 06 06 06 06 06 06 06 06 06 06 06 06 06 06 06 08 00 00 00 00 00 00 00 00 00 04 06 06 06 06 06 06 06 06 06 06 06 06 06 06 06 06 06 06 06 06 06 08 00 00 00 00 00 00 00 00 00 00 00 00 00 04 06 06 06 06 06 06 06 06 06 06 06 06 06 06 06 06 06 06 06 08 00 00 00 00 00 00 00 04 06 06 06 06 06 06 06 06 08 00 00 00 00 04 06 06 06 06 06 06 06 06 08 00 00 00 00 00 04 06 06 06 06 06 06 06 06 06 06 06 06 06 06 06 06 06 06 06 06 06 06 06 06 06 06 06 06 06 06 06 06 06 06 06 06 06 06 06 06 06 06 06 06 06 06 06 06 06 06 06 06 06 06 06 06 06 06 06 06 06 06 06 08 00 00 00 00 00 00 00 00 00 00 04 06 06 06 06 06 06 06 06 06 06 06 06 06 06 06 06 06 08 
