0 0 250 16 3 300
22 22 22 22 22 22 22 22 22 22 22 22 22 22 22 22 22 22 22 22 22 22 22 22 22 22 22 22 22 22 22 22 22 22 22 22 22 22 22 22 22 22 22 22 22 22 22 22 22 22 22 22 22 22 22 22 22 22 22 22 22 22 22 22 22 22 22 22 22 22 22 22 22 22 22 22 22 22 22 22 22 22 22 22 22 22 22 22 22 22 22 22 22 22 22 22 22 22 22 22 22 22 22 22 22 22 22 22 22 22 22 22 22 22 22 22 22 22 22 22 22 22 22 22 22 22 22 22 22 22 22 22 22 22 22 22 22 22 22 22 22 22 22 22 22 22 22 22 22 22 22 22 22 22 22 22 22 22 22 22 22 22 22 22 22 22 22 22 22 22 22 22 22 22 22 22 22 22 22 00 22 22 22 22 22 22 22 22 22 22 22 22 22 22 22 22 22 22 22 22 22 22 22 22 22 22 22 22 22 22 22 22 22 00 22 22 22 22 22 22 22 22 22 22 22 22 22 22 22 22 22 22 22 22 22 22 22 22 22 22 22 22 22 22 22 22 22 22 22 22 
00 00 00 00 00 00 00 00 00 00 00 00 00 00 00 00 00 00 00 00 00 15 15 15 15 00 00 00 00 00 00 00 00 00 00 00 00 00 00 00 00 00 00 00 00 00 00 00 00 00 00 00 00 00 00 00 00 00 00 00 00 33 02 00 02 00 02 00 33 00 00 00 00 00 00 00 00 36 00 00 00 00 00 00 00 02 00 02 00 02 00 00 00 00 00 00 00 33 00 00 00 00 00 00 00 00 00 00 00 00 00 00 00 00 00 00 00 00 00 00 00 00 00 00 00 00 00 00 00 00 00 00 00 00 00 00 00 00 00 00 00 00 00 00 00 00 00 00 00 00 00 00 00 22 22 22 22 22 22 22 00 00 00 00 00 00 00 00 00 00 00 00 00 00 00 33 36 00 14 16 14 17 14 00 00 00 00 00 00 00 00 00 00 00 00 00 00 00 00 00 00 00 00 00 00 00 00 00 00 00 00 00 00 00 00 00 00 00 00 00 00 00 00 00 00 00 00 00 00 00 00 00 00 00 00 00 00 00 00 00 00 00 00 00 00 00 00 00 00 00 
33 36 00 00 00 00 00 00 00 00 00 00 00 00 00 00 00 00 00 00 02 00 02 00 02 00 00 00 00 00 00 00 00 00 00 00 00 00 00 00 00 00 00 00 00 00 00 00 00 00 00 00 00 00 00 00 00 00 00 00 00 31 00 00 00 00 00 00 31 00 00 00 00 00 22 22 22 35 22 22 22 00 28 29 29 29 29 30 38 38 38 00 00 00 00 00 00 32 00 00 00 00 00 00 00 00 00 00 00 00 00 00 00 00 02 00 00 00 00 00 00 00 00 00 00 00 00 00 00 00 00 00 00 00 00 22 22 22 22 22 22 00 00 00 00 00 00 00 00 00 00 00 00 00 00 00 00 00 00 00 00 00 00 00 00 15 15 15 15 15 15 15 15 15 15 31 34 00 00 00 00 00 00 00 00 00 00 00 00 00 00 00 00 00 22 22 22 22 22 22 22 22 22 00 00 00 00 00 22 22 22 22 22 00 22 22 22 22 00 00 00 00 22 22 22 22 22 22 00 00 00 00 00 00 22 22 22 00 00 00 00 00 00 00 00 00 00 00 00 00 
32 35 00 00 00 00 00 00 00 00 00 00 00 00 00 00 00 00 00 00 14 14 14 14 14 16 00 00 00 00 00 00 00 00 00 00 00 00 00 00 00 22 22 22 22 22 22 22 22 22 22 00 00 00 00 00 00 00 00 00 13 37 28 29 29 29 29 30 37 00 00 00 00 00 00 00 00 35 00 00 00 00 13 13 19 13 18 13 19 13 13 00 00 00 00 00 00 32 00 00 00 00 00 00 00 00 00 00 00 00 00 00 00 00 16 00 00 00 00 00 00 00 00 00 00 00 00 00 00 00 00 00 00 00 00 00 00 00 00 00 00 00 00 00 00 00 00 00 00 00 00 00 00 00 00 00 00 00 00 00 00 00 00 00 15 00 00 00 00 00 00 00 00 00 00 37 37 00 02 01 00 00 02 00 01 00 00 00 00 00 22 22 22 22 22 00 00 00 00 00 00 00 00 00 00 00 00 00 00 00 00 00 00 00 00 00 00 00 00 00 00 00 00 00 00 00 00 00 00 00 00 00 00 00 00 00 00 00 00 22 22 22 22 22 22 00 00 00 00 00 
31 34 22 22 22 22 22 22 22 22 22 22 22 22 00 00 00 00 00 00 00 00 00 00 00 00 00 00 22 22 22 22 22 22 22 22 22 22 00 00 00 00 00 00 00 00 00 00 00 00 00 00 00 00 36 00 00 00 00 00 13 13 16 13 19 13 19 13 13 00 36 00 00 00 00 00 00 35 33 00 00 00 00 00 00 00 00 00 00 00 00 00 00 00 00 00 36 32 00 00 00 00 00 00 00 00 00 00 00 00 00 00 00 00 00 00 00 00 00 00 00 00 00 00 00 15 15 15 15 00 00 00 00 00 00 00 00 00 00 00 00 00 00 00 00 00 00 00 00 00 00 00 00 00 00 00 00 00 22 22 22 22 00 15 00 00 00 00 00 00 28 29 29 29 30 37 37 23 23 23 23 23 23 23 23 00 00 00 00 00 00 00 00 00 00 00 00 00 00 00 00 00 00 00 00 00 00 00 00 00 00 00 00 00 00 00 00 00 00 00 00 00 00 00 00 00 00 00 00 00 00 00 00 00 00 00 00 00 00 00 00 00 00 00 00 00 00 00 00 00 
37 37 00 00 00 00 36 00 00 00 00 00 00 00 00 00 00 00 00 00 00 00 00 00 00 00 00 00 00 00 00 00 00 00 00 00 00 00 00 00 00 00 00 00 00 00 00 00 00 00 00 22 22 22 35 22 22 22 22 22 22 22 22 22 00 00 00 00 00 00 35 00 00 00 00 00 00 34 32 00 00 00 00 00 22 22 22 22 22 22 22 22 22 22 22 00 35 31 00 00 00 22 22 22 22 22 22 22 22 22 22 22 22 00 00 00 00 00 00 00 22 22 22 22 22 22 22 22 22 22 00 00 00 00 00 00 00 00 00 00 22 22 22 22 22 22 00 00 00 00 22 22 22 22 22 00 00 15 15 15 15 15 15 00 00 22 22 22 00 00 03 05 05 05 05 05 05 05 05 05 05 05 05 05 05 07 00 00 00 00 18 00 00 00 00 00 18 00 00 00 00 22 22 22 22 22 22 22 22 00 00 00 00 00 00 00 22 22 22 22 22 22 22 22 00 40 00 00 22 22 22 22 22 22 22 22 00 00 00 00 00 00 00 00 00 00 00 00 00 00 
37 37 38 39 00 00 35 00 00 00 00 00 00 02 00 02 00 02 00 00 22 22 22 22 22 22 22 22 22 22 00 00 00 00 00 00 00 00 00 00 00 00 00 00 00 00 00 00 00 00 00 00 00 00 34 00 00 00 00 00 00 00 02 00 02 00 01 00 02 00 34 01 00 00 09 11 00 37 31 36 00 00 00 00 00 00 00 00 00 00 00 00 00 00 00 33 34 37 00 00 00 00 00 00 00 36 00 00 00 33 00 00 00 00 00 00 00 00 00 00 00 00 00 00 00 00 00 00 00 00 00 00 00 00 00 00 00 00 00 00 00 00 00 00 00 00 00 00 00 00 00 00 00 00 00 00 15 00 00 00 00 00 00 00 00 00 00 00 00 00 04 06 06 06 06 06 06 06 06 06 06 06 06 06 06 08 00 00 00 00 00 00 00 00 00 00 00 00 00 00 00 00 00 00 00 00 36 33 00 00 00 00 00 00 00 00 00 00 00 00 00 00 00 00 00 41 00 00 00 00 00 00 00 00 00 00 00 00 00 00 00 00 00 00 00 00 00 00 00 00 
03 05 05 07 00 00 35 00 00 00 00 00 28 29 29 29 29 29 30 00 00 00 00 00 00 00 00 00 00 00 00 00 00 00 00 00 00 22 22 22 22 22 22 22 22 22 22 22 22 00 00 00 00 00 37 00 00 00 00 00 00 00 00 00 00 00 00 00 00 00 37 00 00 00 10 12 00 37 37 34 00 02 00 01 00 02 00 02 00 01 00 00 00 00 00 31 37 37 00 00 00 00 00 00 00 35 00 00 00 32 00 00 00 00 00 00 00 02 00 00 00 00 00 00 00 00 00 00 00 00 00 22 22 22 22 22 22 22 00 00 00 00 00 00 00 00 15 15 15 15 15 00 00 00 00 15 00 00 00 00 28 29 29 30 00 00 00 00 00 00 04 06 06 06 06 06 06 06 06 06 06 06 06 06 06 08 00 00 00 00 00 00 00 00 00 36 33 00 00 00 00 00 00 00 00 00 35 32 00 00 00 00 00 00 00 13 00 00 00 00 00 00 00 00 00 41 00 00 00 00 00 00 00 00 00 00 22 22 22 22 22 22 22 00 00 00 00 00 00 00 
04 06 06 08 00 00 35 00 00 00 00 33 14 19 14 19 14 19 14 00 00 00 36 00 00 17 19 00 00 00 00 00 00 00 00 00 00 00 00 00 00 00 33 00 00 00 00 00 00 33 13 21 23 23 37 23 20 23 23 23 23 20 28 29 29 29 30 21 23 23 37 23 20 00 10 12 21 37 37 37 23 23 28 29 29 29 29 29 30 00 23 23 23 23 00 37 37 37 13 00 00 00 00 00 00 35 00 00 00 32 00 19 36 00 19 00 00 19 00 00 00 00 00 33 36 00 00 00 00 00 00 00 00 00 00 00 00 00 00 00 00 00 00 00 00 15 00 00 00 00 00 15 15 15 15 00 00 00 00 00 13 13 13 13 00 00 00 00 00 00 04 06 06 06 06 06 06 06 06 06 06 06 06 06 06 08 00 00 00 00 00 00 00 00 00 35 32 00 00 00 00 00 00 00 00 00 35 32 00 00 00 00 00 00 13 13 00 00 00 00 00 00 00 00 00 41 00 00 00 00 00 00 00 00 00 00 00 00 00 00 00 00 00 00 00 00 00 00 00 00 
04 06 06 08 00 00 34 00 00 00 00 32 00 00 00 00 00 00 00 00 00 00 35 00 00 00 00 00 00 00 00 00 00 00 00 00 00 00 00 00 00 00 32 00 00 02 00 00 00 32 13 13 13 13 13 13 13 13 13 13 13 13 13 13 13 13 13 13 13 13 13 13 13 13 13 13 13 13 13 13 13 13 13 13 13 13 13 13 13 13 13 13 13 13 13 13 13 13 13 00 00 00 00 00 00 34 00 00 00 31 00 00 35 00 00 00 00 00 00 00 00 00 00 32 35 00 00 00 00 00 00 00 00 00 00 00 15 15 15 15 15 15 15 15 15 00 00 00 00 00 00 00 00 00 00 00 22 22 22 22 22 22 00 00 00 00 00 00 00 00 04 06 06 06 06 06 06 06 06 06 06 06 06 06 06 08 00 00 00 00 00 00 00 00 00 35 32 00 00 00 00 00 00 00 00 00 34 31 00 00 00 00 00 13 13 13 00 00 00 00 00 00 00 00 00 41 00 00 00 00 00 00 00 00 00 00 00 00 00 00 00 00 00 00 00 00 00 00 00 00 
04 06 06 08 00 00 37 00 00 00 00 31 00 00 00 00 00 00 00 00 00 00 34 00 00 00 00 00 00 00 09 11 00 00 00 00 00 00 00 00 00 00 32 00 00 16 00 00 00 32 00 00 00 00 00 00 00 00 00 00 00 00 00 00 00 00 00 00 00 00 00 22 22 22 22 22 22 22 00 00 00 00 00 00 00 00 00 00 00 00 00 00 00 00 00 00 00 00 00 00 00 00 00 00 00 37 00 00 02 37 00 01 34 00 01 02 00 01 00 02 00 00 00 31 34 00 15 15 15 15 15 00 00 00 00 15 00 00 00 00 00 00 00 00 00 00 00 22 22 22 22 22 00 00 00 00 00 00 00 00 00 00 22 22 22 22 22 00 00 00 04 06 06 06 06 06 06 06 06 06 06 06 06 06 06 08 00 33 36 00 00 00 00 00 00 34 31 42 00 00 00 00 00 00 00 00 37 37 00 00 00 00 13 13 13 13 00 00 00 00 00 00 00 00 00 41 00 00 00 00 00 00 00 00 00 00 00 00 00 00 00 00 00 00 00 00 00 00 00 00 
04 06 06 08 00 00 37 00 01 00 00 37 00 00 02 00 02 00 02 00 00 01 37 00 01 00 00 00 00 00 10 12 00 00 00 00 00 00 00 00 00 00 31 00 00 00 00 00 00 31 00 00 00 22 22 22 22 22 22 00 00 00 00 22 22 22 22 22 00 00 00 00 00 00 00 00 00 00 00 00 00 00 22 22 22 22 22 22 22 00 00 00 00 00 00 00 00 00 00 00 00 00 00 00 00 37 00 00 00 37 00 00 37 00 00 00 00 00 00 00 00 00 00 37 37 00 00 00 00 00 00 15 15 15 15 36 00 00 00 00 25 29 29 29 30 00 00 00 00 00 00 28 29 29 30 00 00 00 00 00 00 00 00 00 00 00 00 00 00 00 04 06 06 06 06 06 06 06 06 06 06 06 06 06 06 08 00 31 34 00 00 00 00 00 00 37 37 00 00 00 00 00 00 00 00 00 37 37 00 00 00 13 13 13 13 13 00 00 00 00 00 00 00 00 00 41 00 00 00 00 00 00 00 00 00 00 00 00 00 00 00 00 00 00 00 00 00 00 00 00 
04 06 06 08 21 23 37 23 20 23 23 37 23 23 20 28 29 29 29 30 39 23 37 23 28 29 29 29 29 30 10 12 00 00 00 00 00 00 00 00 00 00 37 00 01 00 00 00 02 37 00 00 00 00 00 00 00 00 00 00 00 00 00 00 00 00 22 22 22 22 22 00 00 00 00 00 00 00 00 00 00 00 00 00 00 00 00 00 00 00 00 00 22 22 22 22 22 22 00 21 28 29 29 29 30 37 20 23 23 37 23 23 37 23 00 23 00 00 28 29 29 29 30 37 37 13 00 00 00 00 00 00 00 00 00 34 00 00 00 00 13 13 13 13 13 00 00 00 00 00 00 13 13 13 13 00 00 00 22 22 22 22 00 00 00 00 00 00 00 00 04 06 06 06 06 06 06 06 06 06 06 06 06 06 06 08 09 11 37 23 23 21 23 20 23 37 37 23 28 29 29 29 29 30 20 23 37 37 23 23 13 13 13 13 13 13 00 00 21 23 23 23 23 21 23 41 23 23 23 21 23 23 24 00 00 00 00 00 00 00 00 00 00 00 00 00 00 00 00 00 
04 06 06 08 05 05 05 05 05 05 05 05 05 05 05 05 05 05 05 05 05 05 05 05 05 05 05 05 05 05 05 07 00 00 00 00 00 00 00 09 11 21 37 28 29 29 29 30 00 37 22 22 22 22 22 00 00 00 00 00 00 00 00 00 00 00 00 00 00 00 00 00 00 00 00 00 00 22 22 22 22 22 22 22 22 00 00 00 00 00 00 00 00 00 00 00 00 00 00 05 05 05 05 05 05 05 05 05 05 05 05 05 05 05 05 05 05 05 05 05 05 05 05 05 05 07 00 00 00 00 00 23 23 23 23 37 00 00 00 00 00 00 22 22 22 22 22 22 00 00 00 00 00 00 00 00 22 22 22 00 00 00 00 00 00 00 00 00 00 00 04 06 06 06 06 06 06 06 06 06 06 06 06 06 06 08 05 05 05 05 05 05 05 05 05 05 05 05 05 05 05 05 05 05 05 05 05 05 05 05 05 05 05 05 05 05 05 05 05 05 05 05 05 05 05 05 05 05 05 05 05 05 05 05 05 05 05 05 05 05 05 05 05 05 05 05 05 05 05 07 
04 06 06 08 06 06 06 06 06 06 06 06 06 06 06 06 06 06 06 06 06 06 06 06 06 06 06 06 06 06 06 08 00 00 00 00 00 00 00 03 05 05 05 05 05 05 05 05 05 07 00 00 00 00 00 00 22 22 22 22 22 00 00 00 00 00 00 00 00 22 22 22 22 22 22 00 00 00 00 00 00 00 00 00 00 00 00 00 00 00 22 22 22 22 22 22 00 00 00 06 06 06 06 06 06 06 06 06 06 06 06 06 06 06 06 06 06 06 06 06 06 06 06 06 06 08 00 00 00 00 00 03 05 05 05 07 00 00 00 00 00 00 00 00 00 00 00 00 00 00 00 22 22 22 22 22 22 00 00 00 00 00 00 00 00 00 00 00 00 00 04 06 06 06 06 06 06 06 06 06 06 06 06 06 06 08 06 06 06 06 06 06 06 06 06 06 06 06 06 06 06 06 06 06 06 06 06 06 06 06 06 06 06 06 06 06 06 06 06 06 06 06 06 06 06 06 06 06 06 06 06 06 06 06 06 06 06 06 06 06 06 06 06 06 06 06 06 06 06 08 
04 06 06 08 06 06 06 06 06 06 06 06 06 06 06 06 06 06 06 06 06 06 06 06 06 06 06 06 06 06 06 08 00 00 00 00 00 00 00 04 06 06 06 06 06 06 06 06 06 08 00 00 00 00 00 00 00 00 00 00 00 00 00 00 00 00 00 00 00 00 00 00 00 00 00 00 00 00 00 00 00 00 00 00 00 00 00 00 00 00 00 00 00 00 00 00 00 00 00 06 06 06 06 06 06 06 06 06 06 06 06 06 06 06 06 06 06 06 06 06 06 06 06 06 06 08 00 00 00 00 00 04 06 06 06 08 00 00 00 00 00 00 00 00 00 00 00 00 00 00 00 00 00 00 00 00 00 00 00 00 00 00 00 00 00 00 00 00 00 00 04 06 06 06 06 06 06 06 06 06 06 06 06 06 06 08 06 06 06 06 06 06 06 06 06 06 06 06 06 06 06 06 06 06 06 06 06 06 06 06 06 06 06 06 06 06 06 06 06 06 06 06 06 06 06 06 06 06 06 06 06 06 06 06 06 06 06 06 06 06 06 06 06 06 06 06 06 06 06 08 
