0 0 250 16 2 300
22 22 22 22 22 22 22 22 22 22 22 22 22 22 22 22 22 22 22 22 22 22 22 22 22 22 22 22 22 22 22 22 22 22 22 22 22 22 22 22 22 22 22 22 22 22 22 22 22 22 22 22 22 22 22 22 22 22 22 22 22 22 22 22 22 22 22 22 22 22 22 22 22 22 22 22 22 22 22 22 22 02 13 22 22 22 22 22 22 22 22 22 22 22 22 22 22 22 22 22 22 22 22 22 22 22 22 22 22 22 22 22 22 22 22 22 22 22 22 22 22 22 22 22 22 22 22 22 22 22 22 22 22 22 22 22 22 22 22 22 22 22 22 22 22 22 22 22 22 22 22 22 22 22 22 22 22 22 22 22 22 22 22 22 22 22 22 22 22 22 22 22 22 22 00 00 00 00 00 00 00 00 00 00 00 00 00 00 00 00 00 00 00 00 00 00 00 00 00 00 00 00 00 00 00 00 00 00 00 00 00 00 00 00 00 00 22 22 22 22 22 22 22 22 22 22 22 22 22 22 22 22 22 22 22 22 22 22 22 22 22 22 22 22 22 22 22 22 22 22 
00 00 00 00 00 00 00 00 00 00 00 00 00 00 00 00 00 00 00 00 00 00 00 00 00 00 02 00 02 00 02 00 00 00 00 00 00 00 00 00 00 00 00 00 00 00 00 00 00 00 00 00 00 00 00 00 00 00 00 00 00 00 02 00 02 00 02 00 00 00 00 00 00 00 00 00 00 00 00 00 02 13 13 00 00 00 00 00 00 00 00 00 33 36 00 00 00 00 00 00 00 00 00 00 00 00 00 36 33 00 00 00 00 00 00 00 00 00 00 00 00 00 00 00 00 00 00 00 00 00 00 00 00 00 00 00 00 00 00 00 00 00 00 00 36 00 33 00 00 00 00 00 00 22 22 22 22 22 22 22 00 00 00 00 00 00 00 00 00 00 00 00 00 00 00 00 00 00 00 00 00 00 00 00 00 00 00 00 00 00 00 00 00 00 00 00 00 00 00 00 00 00 00 00 00 00 00 00 00 00 00 00 00 00 00 00 00 00 00 00 00 00 00 00 00 00 00 00 00 00 00 00 00 00 00 00 00 00 00 00 00 00 00 00 00 00 00 00 00 00 
00 00 00 00 00 00 00 00 00 00 00 00 00 00 00 00 00 00 00 00 00 00 00 00 00 00 14 14 14 14 14 14 00 00 00 00 00 00 00 00 00 00 00 00 00 00 00 00 00 00 00 15 15 15 15 15 15 15 15 15 15 15 33 00 33 00 00 00 00 00 00 00 00 00 00 00 00 00 00 02 13 13 13 00 00 00 22 22 22 22 22 22 32 35 00 00 00 00 00 14 19 14 19 14 00 00 00 35 32 00 00 00 00 00 00 00 00 00 00 00 00 00 00 00 00 00 00 00 00 00 00 00 00 00 00 22 22 22 22 22 22 00 33 00 35 00 32 00 00 00 00 00 00 00 00 00 00 00 00 00 00 00 00 00 00 00 00 00 00 00 00 00 00 00 00 00 00 00 00 00 00 00 00 00 00 00 00 00 00 00 00 00 00 00 00 00 00 00 00 00 00 00 00 00 00 00 00 00 00 00 00 00 00 00 00 00 22 22 00 00 00 00 22 22 22 22 22 22 00 00 00 00 00 00 22 22 22 00 00 00 00 00 00 00 00 00 00 00 00 00 
00 00 00 00 00 00 00 00 00 00 00 00 00 00 00 00 00 00 00 00 00 00 00 00 00 00 00 00 00 00 00 00 00 15 00 15 00 15 00 15 00 22 22 22 22 22 22 22 22 22 22 01 02 01 00 02 38 38 00 36 00 36 32 00 32 00 00 00 00 00 00 00 22 22 22 22 22 00 02 13 13 13 13 00 00 00 00 00 00 00 00 00 31 34 00 00 00 00 00 00 00 00 00 00 00 00 00 34 31 00 00 22 22 22 22 22 22 22 22 00 00 00 00 00 00 00 00 00 00 00 00 00 00 00 00 00 00 00 00 00 00 00 31 01 34 02 31 02 00 00 00 00 00 00 00 00 00 00 00 00 00 00 00 00 00 22 22 22 22 22 00 00 00 00 00 00 00 00 00 00 00 00 00 00 00 00 00 00 00 00 00 00 00 00 00 00 00 00 00 00 00 00 00 00 00 00 00 00 00 00 00 00 00 00 00 00 00 00 00 00 00 00 00 00 00 00 00 00 00 00 00 00 00 00 00 00 00 00 00 22 22 22 22 22 22 00 00 00 00 00 
00 00 22 22 22 22 22 22 22 22 22 22 22 22 00 00 00 00 00 00 00 00 00 00 00 00 00 00 22 22 22 22 22 22 15 22 15 22 15 00 00 00 00 00 00 00 00 00 23 23 23 28 29 29 29 30 37 37 00 34 00 34 31 00 31 00 00 00 00 00 00 00 00 00 00 00 00 00 13 13 13 13 13 00 00 00 00 00 00 00 00 00 37 37 00 01 00 02 00 02 00 02 00 00 01 00 00 37 37 00 00 00 00 00 00 00 00 00 00 00 00 00 00 00 00 00 00 00 00 00 00 00 00 00 00 00 00 00 00 00 00 00 37 00 37 00 37 00 00 00 00 00 00 00 00 00 00 00 22 22 22 22 00 00 00 00 00 00 00 00 00 00 00 00 00 00 00 00 00 00 00 00 00 00 00 00 00 00 00 00 00 00 00 00 00 00 00 00 00 00 00 00 00 00 00 00 00 00 00 00 00 00 00 00 00 00 00 00 00 00 00 00 00 00 00 00 00 00 00 00 00 00 00 00 00 00 00 00 00 00 00 00 00 00 00 00 00 00 00 00 
00 00 00 00 00 00 36 00 00 00 00 00 00 00 00 00 00 00 00 00 00 33 00 33 00 33 00 00 00 00 00 00 00 15 00 15 00 15 00 15 00 00 00 00 00 00 00 13 13 13 13 13 13 13 13 13 13 13 13 13 13 13 13 13 13 13 13 00 00 00 15 00 15 00 15 00 15 00 13 13 13 13 13 00 00 00 00 00 00 00 00 13 37 37 28 29 29 29 30 23 23 23 23 28 29 29 29 37 37 13 00 00 00 00 00 00 00 00 00 00 22 22 22 22 22 00 22 22 22 22 00 00 00 00 00 00 00 00 00 00 00 14 19 14 19 14 16 14 00 00 22 33 22 22 22 00 00 00 00 00 00 00 00 00 00 15 00 15 00 15 00 00 00 00 00 00 00 00 00 00 00 00 00 00 00 00 00 00 00 00 00 00 00 00 00 00 00 00 00 00 00 00 00 00 00 00 00 00 00 00 00 00 00 00 00 00 22 22 22 22 22 22 22 22 00 40 00 00 22 22 22 22 22 22 22 22 00 00 00 00 00 00 00 00 00 00 00 00 00 00 
00 00 00 00 00 00 35 00 00 00 00 00 00 00 00 00 00 00 00 00 00 31 02 31 02 31 01 00 00 00 00 00 00 00 15 00 15 00 15 00 00 00 00 00 00 00 00 00 00 00 00 00 00 00 00 00 00 00 00 00 00 00 33 00 00 00 00 00 00 00 00 15 00 15 00 15 00 00 13 13 13 13 13 00 22 22 22 22 22 22 00 13 13 13 13 13 13 13 13 13 13 13 13 13 13 13 13 13 13 13 00 00 00 00 00 00 00 00 00 00 00 00 00 00 00 00 00 00 00 00 00 15 15 15 15 00 00 00 00 00 00 00 00 36 00 33 00 00 00 36 00 32 36 00 00 00 00 00 00 00 00 00 00 00 00 00 15 00 15 22 22 22 22 00 00 00 00 00 00 00 00 00 00 00 00 00 00 00 00 00 00 00 00 00 00 00 00 00 00 00 00 00 00 00 00 00 36 33 00 00 00 00 00 00 00 00 00 00 00 00 00 00 00 00 00 41 00 00 00 00 00 00 00 00 00 00 00 00 00 00 00 00 00 00 00 00 00 00 00 00 
00 00 00 00 00 00 35 00 00 00 00 00 00 00 00 00 00 00 00 00 00 37 00 37 00 37 00 00 00 00 00 00 00 15 00 15 00 15 22 15 22 22 22 22 22 22 22 22 22 00 00 00 00 00 00 22 22 22 22 22 22 22 32 00 00 00 00 00 00 00 15 00 15 00 15 00 15 00 13 13 13 13 13 00 00 00 00 00 00 00 00 00 00 00 00 00 00 00 00 00 00 00 00 00 00 00 00 00 00 00 00 00 00 00 00 00 00 00 00 00 00 00 00 00 00 00 00 00 00 00 15 22 22 22 00 15 22 22 00 00 00 00 00 35 00 32 00 00 00 35 00 31 35 00 00 00 00 00 00 00 00 22 22 22 22 15 00 15 00 15 00 00 00 00 00 00 00 00 00 00 00 00 00 00 00 00 00 00 00 00 00 00 00 00 00 36 33 00 00 00 00 00 00 00 00 00 35 32 00 00 00 00 00 00 00 00 00 00 00 00 00 00 00 00 00 41 00 00 00 00 00 00 00 00 00 00 22 22 22 22 22 22 22 00 00 00 00 00 00 00 
00 00 00 00 00 00 35 00 00 00 00 33 00 00 00 00 00 00 00 00 14 19 14 19 14 16 14 00 00 00 00 00 00 00 00 00 00 00 00 00 00 00 00 36 00 36 00 00 00 00 00 00 00 00 00 00 02 00 02 00 02 00 32 00 00 22 22 22 22 22 00 15 00 15 00 15 00 00 13 13 13 13 13 00 00 00 00 22 22 22 22 22 22 00 00 00 00 00 02 00 01 00 02 22 22 22 22 22 00 00 00 00 15 00 15 00 00 00 00 15 00 15 00 15 00 00 00 00 00 00 00 00 00 00 00 00 00 00 00 00 00 33 02 34 02 31 01 02 01 34 00 37 35 00 00 00 00 00 00 16 00 00 00 00 00 00 15 00 15 00 20 23 23 23 23 23 00 28 29 29 29 29 30 00 00 00 00 00 00 00 00 00 00 00 00 35 32 00 00 00 00 00 00 00 00 00 35 32 00 00 00 00 00 00 13 13 00 00 00 00 00 00 00 00 00 41 00 00 00 00 00 00 00 00 00 00 00 00 00 00 00 00 00 00 00 00 00 00 00 00 
00 00 00 00 00 00 34 00 00 00 00 32 00 00 00 00 00 00 00 00 00 00 00 00 00 00 00 00 00 00 00 00 00 00 00 00 00 00 00 00 00 00 00 35 00 35 00 00 00 00 00 00 00 00 00 00 39 00 39 00 39 00 32 00 00 00 00 36 00 33 15 00 15 00 15 00 15 00 00 00 00 00 00 00 00 00 00 00 00 00 36 00 00 00 00 00 33 00 00 00 00 00 00 00 00 00 00 00 00 00 00 00 00 15 00 22 00 22 00 22 15 22 15 22 00 00 00 00 22 22 22 22 22 22 00 13 28 29 29 29 30 31 00 37 00 37 23 23 23 37 00 37 34 13 00 00 00 00 00 00 00 00 00 00 00 15 00 15 00 15 03 05 05 05 05 05 05 05 05 05 05 05 07 00 00 00 00 00 00 00 00 00 00 00 00 35 32 00 00 00 00 00 00 00 00 00 34 31 00 00 00 00 00 13 13 13 00 00 00 00 00 00 00 00 00 41 00 00 00 00 00 00 00 00 00 00 00 00 00 00 00 00 00 00 00 00 00 00 00 00 
00 00 00 00 00 00 37 00 00 00 00 31 00 00 00 00 00 00 00 00 00 00 00 00 00 00 00 00 00 00 00 09 11 00 00 00 00 00 00 09 11 00 00 35 00 35 00 00 00 00 00 00 00 00 00 14 16 14 19 14 19 00 31 00 00 00 00 35 00 32 00 00 00 00 00 00 00 00 00 00 00 00 00 00 00 00 00 00 00 00 35 00 00 00 00 00 32 00 14 19 14 16 14 36 00 36 00 00 00 00 00 00 15 00 15 00 00 00 00 15 00 15 00 15 00 00 00 00 00 00 00 00 00 00 00 13 13 13 13 13 13 13 13 13 13 13 13 13 13 13 13 13 13 13 00 00 00 00 00 00 00 00 22 22 22 22 22 00 00 00 04 06 06 06 06 06 06 06 06 06 06 06 08 00 00 00 00 33 36 00 00 00 00 00 00 34 31 42 00 00 00 00 00 00 00 00 37 37 00 00 00 00 13 13 13 13 00 00 00 00 00 00 00 00 00 41 00 00 00 00 00 00 00 00 00 00 00 00 00 00 00 00 00 00 00 00 00 00 00 00 
00 00 00 00 00 00 37 00 00 00 00 37 00 00 00 00 00 00 00 00 00 01 00 02 00 01 00 02 00 00 00 10 12 00 00 00 00 00 00 10 12 00 00 34 00 34 00 00 00 00 00 00 00 00 00 00 00 00 00 00 00 00 37 00 00 00 00 34 00 31 00 00 00 00 36 00 00 33 00 00 36 00 00 00 00 00 00 09 11 00 34 00 00 00 00 00 31 00 36 33 00 00 00 35 00 35 00 00 00 00 00 00 00 00 00 00 00 00 00 00 15 00 15 00 00 00 00 00 00 00 00 00 00 00 00 00 00 00 00 00 00 00 00 00 00 00 00 00 00 00 00 00 00 00 00 00 00 00 00 28 29 29 29 29 30 00 00 00 00 00 04 06 06 06 06 06 06 06 06 06 06 06 08 05 07 00 00 31 34 00 00 00 00 00 00 37 37 00 00 00 00 00 00 00 00 00 37 37 00 00 00 13 13 13 13 13 00 00 00 00 00 00 00 00 00 41 00 00 00 00 00 00 00 00 00 00 00 00 00 00 00 00 00 00 00 00 00 00 00 00 
21 00 00 00 00 23 37 23 20 23 23 37 23 23 20 28 29 29 29 30 21 23 00 23 28 29 29 29 29 30 00 10 12 00 00 00 00 00 00 10 12 00 00 37 00 37 02 00 02 00 02 00 00 01 00 00 00 01 00 00 00 00 37 00 09 11 00 37 00 37 00 00 00 02 34 01 02 31 01 02 34 00 00 00 00 00 00 10 12 00 37 01 00 02 00 02 37 02 34 31 01 00 00 34 00 34 00 00 00 00 00 22 22 22 22 00 00 00 00 15 22 15 22 15 22 28 29 29 29 30 00 00 22 22 22 22 22 00 00 00 00 00 00 00 00 00 00 00 00 00 00 00 00 00 00 00 00 00 00 13 13 13 13 13 13 00 00 00 00 00 04 06 06 06 06 06 06 06 06 06 06 06 08 06 08 21 00 37 37 23 23 21 23 20 23 37 37 23 28 29 29 29 29 30 20 23 37 37 23 23 13 13 13 13 13 13 00 00 21 23 23 23 23 21 23 41 23 23 23 21 23 23 24 00 00 00 00 00 00 00 00 00 00 00 00 00 00 00 00 00 
03 05 05 05 05 05 05 05 05 05 05 05 05 05 05 05 05 05 05 05 05 05 05 05 05 05 05 05 05 05 05 05 07 00 00 00 00 00 00 10 12 21 23 37 23 37 00 21 25 26 26 27 20 25 26 26 26 27 21 20 23 23 37 23 10 12 21 37 23 37 23 23 20 23 37 23 23 37 23 23 37 28 29 29 29 30 21 10 12 20 37 25 26 26 26 27 37 20 37 37 23 00 23 37 23 37 23 25 26 26 26 27 00 00 00 00 23 23 00 00 00 00 00 00 00 13 13 13 13 13 00 00 00 00 00 00 00 00 00 00 00 00 22 22 22 22 22 22 00 00 00 00 00 00 00 00 22 22 22 00 00 00 00 00 00 00 00 00 00 00 04 06 06 06 06 06 06 06 06 06 06 06 08 06 08 05 05 05 05 05 05 05 05 05 05 05 05 05 05 05 05 05 05 05 05 05 05 05 05 05 05 05 05 05 05 05 05 05 05 05 05 05 05 05 05 05 05 05 05 05 05 05 05 05 05 05 05 05 05 05 05 05 05 05 05 05 05 05 05 07 
04 06 06 06 06 06 06 06 06 06 06 06 06 06 06 06 06 06 06 06 06 06 06 06 06 06 06 06 06 06 06 06 08 00 00 00 00 00 00 03 05 05 05 05 05 05 05 05 05 05 05 05 05 05 05 05 05 05 05 05 05 05 05 05 05 05 05 05 05 05 05 05 05 05 05 05 05 05 05 05 05 05 05 05 05 05 05 05 05 05 05 05 05 05 05 05 05 05 05 05 05 05 05 05 05 05 05 05 05 05 05 07 00 00 00 00 03 05 07 00 00 00 00 00 00 00 00 00 00 00 00 00 00 00 00 00 00 00 00 00 00 00 00 00 00 00 00 00 00 00 00 22 22 22 22 22 22 00 00 00 00 00 00 00 00 00 00 00 00 00 04 06 06 06 06 06 06 06 06 06 06 06 08 06 08 06 06 06 06 06 06 06 06 06 06 06 06 06 06 06 06 06 06 06 06 06 06 06 06 06 06 06 06 06 06 06 06 06 06 06 06 06 06 06 06 06 06 06 06 06 06 06 06 06 06 06 06 06 06 06 06 06 06 06 06 06 06 06 06 08 
04 06 06 06 06 06 06 06 06 06 06 06 06 06 06 06 06 06 06 06 06 06 06 06 06 06 06 06 06 06 06 06 08 00 00 00 00 00 00 04 06 06 06 06 06 06 06 06 06 06 06 06 06 06 06 06 06 06 06 06 06 06 06 06 06 06 06 06 06 06 06 06 06 06 06 06 06 06 06 06 06 06 06 06 06 06 06 06 06 06 06 06 06 06 06 06 06 06 06 06 06 06 06 06 06 06 06 06 06 06 06 08 00 00 00 00 04 06 08 00 00 00 00 00 00 00 00 00 00 00 00 00 00 00 00 00 00 00 00 00 00 00 00 00 00 00 00 00 00 00 00 00 00 00 00 00 00 00 00 00 00 00 00 00 00 00 00 00 00 00 04 06 06 06 06 06 06 06 06 06 06 06 08 06 08 06 06 06 06 06 06 06 06 06 06 06 06 06 06 06 06 06 06 06 06 06 06 06 06 06 06 06 06 06 06 06 06 06 06 06 06 06 06 06 06 06 06 06 06 06 06 06 06 06 06 06 06 06 06 06 06 06 06 06 06 06 06 06 06 08 
